########
#......#
#.o..#x#
#.#.o..#
#..@.x.#
########